000000000007777777777000000000000000000000777777777777777-
000005000007777777777033333333333333333330777777777700000-
000003000007777777777030000000000000000030111111111104440-
000003333307777777777030000333333333333334444444444444640-
000000000307777777777030000300000000000030111111111104440-
033333000307777777777033333300000000333330777777777700000-
030003000307777777777000000000000000300000777777777777777-
033333333307777777777000003333300000300000777777777777777-
000003000007777777777000003000300000303330777777777777777-
000003000001111111111000003033333333333330777777777777777-
000003333344444444444433333033300000333000777777777777777-
000000000000000000000000000000000000000000777777777777777-